7
8
11111111
10000001
11110101
10000101
10110011
10001001
11111111